-----------------------------------------------------------------------------------------------------
|   |       |         |     |     |                   | |           | |       |       |   |     |   |
--- - - --- --- ------- - --- --- - --------- ------- - - - ------- - - --- - - ----- - - --- - - - -
|   | |   |   |   |     |   | |   | | |     | | |   | |   |       | |     | | |     | | |     |   | |
- --- --- --- --- - ------- - - --- - - --- - - - - - - --------- - ------- - ----- - - ----- -------
| | | | |   |   |   |     |   |     | |   |   |   |   |         | |   |   | | |     |   |   | |     |
- - - - --- --- --- ----- ----------- --- ----- --------------- - --- - - - - - ----- --- - --- --- -
| |       | | |   | |     |             |     | |   | |   |     | |     |   |   |     |   |   | |   |
- --------- - --- - - --- ----- --------- --- - - - - - - - ----- ----------- --------- ----- - - - -
|       |   | |   |   |   |     |       |   | | | | |   | |   |   |   |   |   |     |   |   |   | | |
------- - --- - ------- --- --- - ----- ----- - - - ----- --- - --- - - - - --- --- - --- - ----- - -
|     |   |   |   |   | |   |   |     |       | | |     |     |   | | | | | |   | |   |   | |     | |
----- ----- - --- - - - --- - ------- --------- - ----- --------- - - - --- - --- ----- --- - ----- -
|         | |   | | |       |   |   | |       | |   |             | | |   | |         | |     |   | |
- - ----- ----- - ------------- --- - --- - --- --- --------------- - --- - --------- - - ----- --- -
| | |   | |   | |       |     |     |   | |   |     |       |     | |   | |   |       | | |   |   | |
- --- - - - - - ------- - - ------- --- - --- ----- - ----- - --- - --- - --- - ------- - - - --- - -
|     | |   |   |     | | |       | |   |   |     | |   |   |   | | | | |     | |   |   | | |   | | |
- ----- - ------- --- - ----- --- - - ------- --- - --- - ----- - - - - - ----- - - - --- - --- - - -
|   | | | |       |   |     |   |   |       |   | |   | |     | | | | | | |   |   | | |   | |   | | |
--- - - --- ------- - ----- --- ----------- - - ----- - ----- - - - - - --- - --- --- ----- - --- - -
| | | |   | |     | | |     | | |   |       | |     | |     |   |   | |   | |     |   |   | |   | | |
- - - --- - ----- - --- ----- - - --- ------- ----- - ----- --------- --- - ------- --- - - --- - - -
| | |   |   |     |     |         |   |   |       |   |     |     |     |   |     |     |   |   | | |
- - - ------- --- ------- --------- --- - ------------- ----- --- --- ------- --- - --------- --- - -
|   |         |   |   |   |       |     |         |           |       |       |   |         | |   | |
- --- ----- ----- - - --- - ----- - ------------- - --------------- --- --------- ----------- - --- -
|   | |   |     |   |   | |   |   |     | |       | | |           | |   |       |             |     |
--- - --- ----- ------- ----- - ------- - - ------- - - --------- - - - - ----- --------------- -----
| | |         |   |           | |   |   | | |         |   |   |   | | | |     | |     |       | |   |
- - ----- ----- - ------------- - - - --- - - ----------- - --- --- - ------- - --- --- ----- - - - -
| | |     |   | |     |     | |   | | |   |   |     |     | |   |   |         |   |     |     | | | |
- - --- --- - - ----- - --- - ----- - - - ------- --- ----- - ------- ----- ----- - ----- ----- - ---
| |   |   | | | |     | |       |   |   |       |   | |   |   |     | |   |   |   |     | |   | |   |
- --- ----- - --- ----- --- ----- ------------- - - - - --- ----- - --- - ----- --------- - - - --- -
|   |       |   | |   |   | |   | | |           | | | |       |   |     | |     |       |   | |   | |
--- ----------- - - --- - - - - - - - ----------- - - - ----- - --------- - ------- --- ----- --- - -
|     |         | |     | | | |   | | |           | | | |   |   |   |   |   |       |   |       |   |
- - --- --------- - ----- - - ----- - ----------- - - --- - ------- - - ----- ------- --- ----- --- -
| | |   |         |   | | | | |     |           | | |     |   |   | | |   |   |     | |   |   |   | |
- - - ----------- --- - - --- - --------------- --- --------- - - - - --- - - ----- - - --- - - --- -
| | |   |         |     |   | |           |   |   |   |   |   | | |     |   |     |   |     | | |   |
- ----- - ----------------- - ----- --- --- - --- --- - - - --- - ----------- --- - --- ----- - - ---
|     | |   |     |     |   | |     |   |   |   |     | |   |   |   |       | |   | |     |   | | | |
- --- - --- - --- - --- - --- - --------- --- ------- - ----- ----- - ----- --- --- --- --- --- - - -
| |   |   | |   |   | | |   | | |         | |     |   | |     |   | | |   |     |     | |   |   | | |
--- ----- - --- ----- - --- - - - --------- --- --- --- - --- - --- - - - ----------- --- --- --- - -
|   |     |   |   |   |     | | |   |   |     | |   |   | |   |       | |         |       |     |   |
- --- ------- --- - - ----- - - --- - - - - --- - --- ----- ----------- --------- ----------- ----- -
| |   |       |   | |   |   | |   |   |   | |   | |   |   | |         | | |     | |         | |     |
- - --- - ----- --- --- - --- - --------- --- - - - --- - - - ------- - - - - - - - ------- - - -----
| | |   | |     |   |   | | | |     |     |   | | | |   |   |       |   |   | | |       |   | |   | |
- - ----- - - ----- ----- - - --- - - ----- - --- - --- ----------- ----- --- - --------- --- --- - -
| |       | | |   |         |   | |     |   | |   | |   |       | | | |   |   | |         |     |   |
- --------- --- - ------------- ------- - ----- --- - --- --- - - - - - --- --- - --- ------------- -
|           |   |             |       | |       |   |     |   |   | | | | |   | |   | |             |
- ----- --- - ------------- - ------- ----------- --------- ------- - - - --- ----- - - -------------
|     | |   | |     |       | |     |             |       |     |   | | |   |   |   | |     |       |
--- --- - --- ----- - --- ----- --- --------------- - --- ----- - --- - - - --- - --------- --- --- -
|   |   |   | |     |   | |     | |               | | |   |     |   |     | |   | |     |   |   | | |
----- ----- - - ------- --- ----- ------- ------- --- - --- --- --- --------- - - - --- - --- --- - -
|     |     | |   |   |     |   |       | |   |   |   |     | | |   |         | | | |   | |   |   | |
- ------- --- - - - - ------- - --- ----- - - - --- --------- - - --- ------- --- - - --- - --- --- -
| |     |   | | |   |         | |   |     | | | |   |           | |   |     | |   | |     | | |     |
- - --- --- - - --------- ----- - --- --- - - - - - ----- ------- - - --- --- - - - ------- - - -----
| |   | |   | | |     |   |   |   |   |   | | |   | |   |   |   | | |   |     | | | |   |   | |   | |
- - --- - --- - - --- - --- ----- - ------- - --- --- - --- --- - ----- - ----- --- - - - - - --- - -
| | |   |   | |   | | | | |       | |       |   | |   | |       | |   | | |   |     | |   | |       |
- - - ----- - ----- - - - - ------- - --------- --- --- ------- - - - - - - - ------------- ------- -
| | | |     |     |   | |       |   | | |     |       |       | |   |   | | |   |         |     |   |
- - - ----------- ----- - ------- --- - - --- --------------- - --------- - --- - --- --- - --- - ---
| | |   |         |   | | |       |   |     |       |   |     |         | | |   |   | |   | | | |   |
- - --- - --------- - - - - ----- - ------- ----- - - - - --------- ----- - - ------- - --- - - -----
| | | |   |     |   |   | | |     |     |   |     | | |   |       | |   |   |         | |     |     |
- - - ------- - - ------- - - --------- --- - ----- - ----- ------- - - --------------- --------- - -
| |   |       |   |     | | | |   |   |   | | | |   | |           | | |       |       |   |     | | |
- --- - ------- ------- - - --- - - - --- --- - - --- ----- ----- - - - ------- --- ----- - --- --- -
|     | | |   | |     |   |     |   |   |   | |   |   |   | | |   | | | |       | | |   |   | | |   |
- ----- - - - - - --- ------------- - ----- - - --- --- - - - - --- - - - ------- - - - ----- - - - -
| |     |   |   |   | |       |   | |         | |   |   | |   | |   | |   |     | |   |         | | |
- - - --- --------- - - ----- - - --------------- --- --- ----- - --- ----- --- - --------------- - -
| | | |     |     | |   |       |   |             |   | |     |     | |     | | |                 | |
- --- ----- - - --- - ----- ------- - --------- --- --- ----- ----- - --- --- - - ----- ----------- -
|     |   |   | |   | |   | |   |     |       | |   |     | |   |   |     |   | | |     |         | |
----- - - ----- - --- - - --- - ------- ------- - --- --- - --- - --------- --- - - ----------- --- -
|     | |     | | |   | |     |     |           |     |   | |   | |             | |   |       | |   |
- ----- ----- --- - --- ----------- ----------- ------- --- - ----- ------------- --- - ----- - - ---
|     |   | |     | | |   | |     |     |     |   |   |   | |       |         | |   |       | |     |
--- ----- - ------- - --- - - --- ----- - --- --- - - --- - ----------- ----- - --- ------- - ----- -
|   |     |           |   | | |   |   | |   | |   | | |   |             |     |     |     | |   |   |
- --- --- ----------- - --- - --- - - - --- - - ----- - ----- - --------- ----- ----- --- ----- -----
| |   |   |   |   |   |     |   |   |     | | |       |     | | |       | |     | |   |       |     |
--- ------- - - - ------- ----- --- ----- - - ------- ----- - - --- - --- - ----- - --------- ----- -
|   |       |   |   |   | |     |   |   | | | |   | | |     | |   | |   | |       |     |   |       |
- --- ------------- - - - - ----- --- - --- - - - - - - ----- --- - --- - ------- ----- - - ------- -
|   | | |       | |   | | | |   |   | |     | | | |   | | |     | |   |   |       |     | | |     | |
- - - - - - --- - ----- - - - - ----- ------- - - ----- - - ----- --- ----- ------- ----- --- - --- -
| | | |   |   |     | | | | | |       |   |   | | |   | |   |     | | |   |       | |     |   |     |
- - - ------- ----- - - - - - --------- - - --- - - - - ----- ----- - - - --------- - ----- ---------
| |           |       |   |             | |     |   |         |         |           |               |
-----------------------------------------------------------------------------------------------------
