#####################################################################################################
# #             #       #       #       #             #             #   #     #     #   #           #
# ##### ####### ### ### # ##### # # ##### ######### ### ########### # # # # ### # # # ### ####### ###
#       #     #   #   #   # #   # # #     #     # #   #   #   #   #   #   #     # #   #   #   # #   #
######### # # ### ### ##### # ### # # ##### ### # ### ### ### # # ##### ######### ### # ### # # ### #
#   #     # #   #   # #     # #   # #     # #     #   #       # #     #   #     #   # #     #   # # #
# # # ##### ### ### # ### # # ##### ##### # ####### ### ####### ##### ### # ### ### ### ####### # # #
# #   #   # # # # # #   # #   #   # #     # #     #   # #     # #   # #   # #     #     #     #   # #
# ##### # # # # # # # # # ##### # # # ##### # ### ### # # ### # # # # # ##### ########### ### ### # #
# #   # #   #   # # # # #       # #   #     #   #   # # # #   # # #   #     #         #   # # #   # #
# # ### # ##### # # # # ######### ### ### # ### ### # # # # ### ##### ##### # ### # ### ### # ##### #
# #   # # #   #   # # #   #     #   #   # #   #   # #   # # #   #   #   # # # #   # #   #   #       #
# ### # ### # ##### # ### # ####### ### ### # ### # ##### # # # # # ### # # # # ### # ### # ####### #
#   # #     # #     # #   #       # # #     #   # #       # # #   # #   # # # # #   # #   #   # #   #
### # ####### # ##### # ##### # ### # ######### # ######### ##### # # ### # ### # ### ##### # # # ###
#   #   # #   # #   # # #   # # #   #           # # #     #     # # # #       # # # # #   # #   #   #
# ### # # # # # # # ### # # # # # ####### ####### # # ### ##### ### # ####### # # # # # # # ### ### #
#     # # # # #   # #   # # # #         # #     # # #   #         # #     # # # #   #   # #   #   # #
####### # # ####### # ### # ########### # # ### # # ### ######### # ##### # # # ######### ### ##### #
#     #   #         # #   #     #     # # #   # # # #   #       # #   #   # # #   #     #   #       #
# # ##### ########### # ####### # ##### ##### # # # # ### ##### # ### # ### # ### # ### # # # #######
# #     # #   # #     # #     # # #   #       #   #     #     # #   # #   #     # #   # # # # #     #
# ##### # # # # # ### # # ##### # # # ############# ######### # ### # ### ##### # ### # ### # # ### #
# #   #   # # #   #   # #   #   # # #         #     #     #   # # # #   #     #   #   #   # #   # # #
# ### ##### # ##### ### # # # ### # ##### ### # ##### # ### ### # # ### ##### ##### ##### # ##### # #
#     #     #     # #   # # #   #   #   #   #   #     #     #   # # #   #   #     #   #     # #     #
##### ##### ##### # # ##### ### ### # # ######### ######### # ### # # ### ####### # # ####### # #####
#   #       # #   #   #   #   #   # # #       #   #   #   # #   # # #   #       # # #     # #   #   #
### ######### # ### ### # # ##### ### ####### # ### ### # ##### # # # # # ##### # # ##### # # ### # #
#   # #       #   #     # #     #     # #   # #   # #   #     # #   # # # #     # #   #   # #   # # #
# # # # ### # ### ####### ##### ####### # # # ### # # # ##### # # ##### ### ##### ##### ### ### # # #
# #   #   # #   #     #           #       # #   # # # # #   #   #     #   # #   # #     #     # # # #
# ### ### # ######### ########### # ####### ### # # # ### # ######### ### # # # # # ##### # ### # ###
# #     # #         # #   # #   # #     #     #   # # #   # #       #     #   #   # #     # #   #   #
# ##### # ##### ### # # # # # # # ####### ######### # # ### # ##### ####### ####### # ### ### ##### #
#   # # #   # # #   # # # #   #         #         # #     # #     # # #   #         #   #   # #   # #
### # # ### # # ### # # # ############# ### ### # # ####### ### ### # # # ############# ### # # # # #
#   #   # #   #   # # # #           # #   # #   #   #     #     #   # # #         #   # #   #   # # #
# ### ### ### ### ### # ########### # ### ### ##### # ### ### ### ### # ######### # # # # ####### # #
# #       #     # #   #   #       # #   #   # #   # # # #   #   # # #   #   # #   # # # #       #   #
# ######### ##### # ### # ### ### # # # ### # # ### # # ### ##### # # ### # # # ### # # ####### ### #
#         # # #   # # # #   #   #   # #   #   # #   # #   #       #   #   # # #     #   # #   #     #
# ####### # # # ### # # ### ##### ### ### ##### # ### # ########### ##### # # ########### # # ### ###
#       #   # #     # #   # #   # #     #   #   #   # # #                 #               # #   # # #
####### ##### ####### ### # # # # # ### ### # ##### # # # ######### ####### ############### ### # # #
#   #   #         #   #   #   # # #   #   #   #     # #     #     # #   #   #   #   #     # # # #   #
# ### ### ##### # ### # ####### # ### ### ##### ##### # ##### ### ### # # ### # # # # ### # # # ### #
# #   # # #     #     #   #     # # #   #   #   #     # #   # #   #   # # #   #   # #   #   # #   # #
# # ### # # ############# # ##### # ### ### # ### # ##### # # # # # ### ### ####### ### ##### ### ###
#   #     #         #     #     # #       #   #   # #     #   # # # # #     #   # #   #         #   #
# ##### ######### # # ##### ### # ############# # ### ######### ### # ####### # # ### ### ######### #
#     #     #   # # # #   # #   #             # # #   # #     #   #   #       #     #     #   #   # #
##### ####### # # # # # # ### ############### # ### ### # ### ### ### # ### ############### # # # # #
#   #       # # # #   # #   # #       #   #   #   #     # #       #   # #   #   #           #   #   #
# ######### # # # ##### ### # # ##### ### # ##### ### ### # ##### # ##### ### # # ####### ######### #
#         #   # # # #   # # #     #   #   #         # #   # #   # #     # #   # #     #   #   # #   #
# ####### ##### # # # ### # ####### ### ########### # # ##### # ####### # # ### ##### ### # # # # ###
# #     #     # #   # #   #     #   #             # # #       # #     # #     #     #   # # # # # # #
# ##### # ### # ### # ### ##### # ##### # ######### # ##### ### # # ### # ####### # ### ### # # # # #
#       #   # #   # #   #   #   #     # #   #   #   # #   #   # # #     #   #     # # #   # # #   # #
####### ### ##### ##### # # # ####### # ### # # # ### # # ### # # ########### ##### # ### # # # ### #
#         #     #       # # # #       #   #   # #   # # # #   # # #   #     #     #     #   # #     #
# ############# ######### ### # ############### # ### # # ##### # # ### # # ### # ########### #######
#     #   #   #   # #         #         #     #   #   # #       # #     # #   # #           #       #
### ### # # # # # # # ######### ####### # ### ##### ### ####### # # ##### ### ### ####### # ####### #
#   #   #   # # #   #     #   #   #     #   #     #   #       # # # #     # #   # # #   # #   #   # #
##### ####### # ### ##### ### ### # ### ### ##### ### ####### ### ### ##### ### # # # # ### # ### # #
#     #       # #       #   #     # #   #   # #     # #     #   #   #     #   # #   # #   # #     # #
# ########### # ########### # ##### ### # ### # ##### # ### ### ### # ### # ### ##### ### # ##### # #
#           #   #           # #   #   # # #   #       # # #   #     #   # #     #     # #   #   # # #
# ####### # # ### ########### # # ### ### ### ##### ### # ### ### ##### # # ##### ##### ### # # ### #
# # #   # # # #   #         # # #     #       #   # #   #   #   # #     # #   #     # #     # # #   #
# # # # ### # # ##### ##### # # ####### ####### # ### ### # ### # ####### ### ### # # # ##### # # # #
# # # # #   # #     # #   #   #     #     #     #     #   #   # # #       # #   # # #     #   #   # #
# # # # # ### ##### ### # ######### # ##### ########### # ### # # # ####### ### # # ##### # ####### #
#   # # # #       #   # #         #   #     #         # #   # # #   #         # # #     # # #       #
##### # # # ##### ### # ######### ##### ####### ##### # ### # # ##### ####### # ####### # # ##### ###
#   # #   # #   # #   # #     # #   #   #     #   #   #   # # #   #         # #   #   # # #     #   #
# # # ##### # # ### ### # ### # ### # # # ### ### ### ##### # ### ########### ### # # # ####### ### #
# # # #   # # #     #   # # # #   #   # # # #   #   #       # #   #             #   #   #     # #   #
# # # # # # # ######### # # # # ### ##### # ### ### ######### # ### ####### ####### ##### ### # # ###
# #   # # # # #         # # # #     #     #   #   # #     #   # #     #     #     # #   # # # # # # #
# ##### # ### # ### ##### # # # ##### ##### # ### # # ### # ### ##### # ##### # ### # # # # # # # # #
# #   # #     # #   #       # # #     #     # # # #     # # #   #     # #     #     # #   # #   #   #
# # # # ######### ### ####### ### ##### # ### # # # ##### ### ### ####### ########### ##### ####### #
#   #   #       # #     #     #   #     # #     # # # #   #   # #         #   #       # #     #   # #
# ######### ### # # ##### ### # ######### # ##### # # # ### ### # ######### # # ####### # ### # # # #
# #       #   # #   #   # # # # #         # #     #   #   # #   #     #     # #   #   #   # #   #   #
# # ##### ### # ##### # # # # # ### ##### ### ####### ### # # # ##### # ##### # # # # # ### #########
# # #   #   # #       # # # # #     #     #   # #     # #   # #       # #   # # # # # #     #       #
# # # # ### # ######### # # # ##### ####### ### # ##### ########### ### ### # ### # # ##### # ### # #
#   # #   #   #     #   # #   #   # #       #   #   #   #         #   #   #       # #   #   # #   # #
##### ########### # # ### ##### # # # ####### # ### # # # # ##### ####### ######### ### # ##### #####
# #               # #   #       #   #   #     #   # # # # # #       #   #   #     # # # #     # #   #
# # ####### ########### # ############# # ### ### # # # ### ####### # # # # # ### # # # ##### # # # #
# # #     # #         # #       #   #   #   # #   #   #   #     # # # # # #     # #   #     # #   # #
# # # ### # # ####### # ######### # # ### ### ########### ##### # # # # # ####### ##### ##### # ### #
# # #   # #   #   #   #         # # # # # #   #   #       #   # # #   # # #       #     #     #   # #
# # ### # ####### # ########### # # # # # # ### # # ####### # # # ##### ### ####### ##### ######### #
#       #         #               #   #   #     #           #   #           #                       #
#####################################################################################################
