+-+-+-+-+-+-+-+-+-+-+-+-+-+-+-+-+-+-+-+-+-+-+-+-+-+-+-+-+-+-+-+-+-+-+-+-+-+-+-+-+-+-+-+-+-+-+-+-+-+-+
|         |       |       |       |       |       |                     |         |             |   |
+-+-+-+-+ +-+-+ + + +-+-+ + +-+-+ + +-+-+-+ + +-+ + +-+-+-+-+ +-+-+-+-+ + +-+-+-+ + +-+-+-+-+ + +-+ +
|       |   |   |   |   |   |   | | |   |   |   | | |     |   | |     | | |     | | |     |   |   | |
+-+ + +-+-+ + +-+-+-+ + +-+-+ +-+ + + + + +-+-+ +-+ + +-+-+ +-+ + + +-+ + +-+-+ + + + +-+ + +-+-+ + +
|   | |     |     |   |     |   | |   | | |   | |   | |     |     |   | |   |   |   | | | | |     | |
+ +-+-+ +-+-+ +-+ +-+-+-+-+ + + + +-+-+ + +-+ + + +-+ + +-+-+-+-+-+-+ + +-+ + + +-+-+ + + + + +-+-+ +
|       |   |   | |       |   | | |   |       | |     |   |       |   |   |   | |     |   | | |     |
+ +-+-+-+ +-+-+ + + +-+-+ +-+-+ + + + +-+ +-+-+ +-+-+ +-+ + +-+-+ + +-+-+ +-+-+ + +-+-+ +-+ + + + +-+
|     |   |   | |       |     |     |   | |   |         |     | | |   |   |       |   | |   | | |   |
+-+-+ +-+ + + + +-+-+-+ +-+-+ +-+-+-+-+ + + + +-+-+ +-+-+-+-+ + + +-+ + +-+ +-+-+-+ + + + +-+ + +-+ +
|   |   |   |   |     |   | |   |       | | |     | |       |   |   | | |   |       | | | |   | |   |
+ + +-+ +-+-+-+-+ +-+ +-+ + +-+ +-+ +-+-+-+ +-+-+ +-+ +-+-+ +-+-+-+ + + +-+ + +-+-+-+ +-+ + +-+-+ + +
| |   |         |   |   |     |   |   |     |   |     |   |   |     | |   | | |     |     |       | |
+ +-+ +-+-+-+-+ + + +-+ +-+ +-+-+ +-+ + +-+-+ + +-+-+-+ +-+-+ + +-+-+ +-+ +-+ +-+ + +-+-+-+-+-+-+-+ +
| |         |   | | | |   | |     |   | |     |     |   |   |   |   |   |     |   | |     |       | |
+ + +-+-+-+ + +-+ + + +-+ +-+ +-+-+ +-+ + +-+-+-+-+-+ + + + +-+-+ +-+ + +-+-+-+ +-+ + +-+ +-+ + +-+ +
| | |     | |   | | |   |   |     |     |       |     |   |       |   |         |   | |       | |   |
+ + +-+-+ + +-+ + + +-+ +-+ +-+-+ +-+-+-+ +-+-+ + +-+-+-+ +-+ +-+ + +-+-+-+-+ +-+ +-+ +-+-+-+-+ + +-+
| |   |   | | | | |   |   |     |     | |     | | |     |   |   | |     |   |   |     |     |   |   |
+ +-+ + +-+ + + +-+-+ +-+ +-+-+ + +-+ + +-+-+ + + + +-+ +-+-+-+ +-+-+-+ + +-+-+ +-+-+-+ +-+ +-+-+-+ +
| |   |   |   |     | |   |   | | |   |   |   |   |   |   |   |     |   |     |     |   |   |       |
+-+ +-+-+ +-+ +-+-+ + + + + +-+ +-+ +-+ + + +-+-+-+-+ +-+ + + +-+-+ + +-+-+-+ +-+-+ + +-+ + + +-+-+-+
|   |       | |   | | | | |   |     |   |   |   | |   | |   |     | |         |   | |   | | |     | |
+ +-+-+ +-+ + + +-+ + + + +-+ +-+-+-+ +-+-+-+ + + + +-+ +-+-+-+-+ + +-+-+-+-+ + +-+ +-+ + +-+-+-+ + +
| |   |   | |   |   | | |   |     |   | |     |   |   |     | |   |     |     |   |     |       | | |
+ + + +-+ +-+-+ + +-+ + +-+ +-+ + + +-+ + +-+ +-+-+-+ +-+ + + + +-+-+ +-+ +-+-+-+ +-+-+-+-+-+-+ + + +
|   |   | |     |     | |       | |   | | | |   |     |   |   |       |   |     |             |   | |
+ +-+-+ + + +-+-+-+-+-+ + +-+-+-+-+-+ + + + +-+ + +-+-+ +-+-+ +-+-+-+ + +-+ + + +-+-+ +-+ +-+ +-+-+ +
| |   | | |           | | |         | | |   |   | | |   |         |   | | | | |     | |   | | |     |
+ + +-+ + +-+-+-+-+-+ + +-+ +-+-+-+ + + +-+ + + + + + + +-+-+-+ +-+ +-+ + + + +-+-+ +-+ +-+ + + +-+ +
| | |   |           | |   | |     |   |     | | | | | |       | |   |   |   |     |     |   | | |   |
+ + + +-+ +-+-+-+ + + + + + +-+ +-+-+-+-+-+ + + + + + +-+-+-+ +-+ +-+ +-+-+-+ +-+ +-+-+-+ + + + + +-+
|   | |     |   | | | | | |   |       |   | | | | |   |     |     |   |     |   | |     | |   | |   |
+-+ + +-+-+ + + + +-+ +-+ +-+ +-+-+ + + + + + + + +-+ +-+-+ +-+-+-+ +-+-+ + +-+-+ + +-+ + +-+-+-+-+ +
|   |   | |   | |   |   |   | |     |   | | | | |   |   |       |   |     |       |   | |   |       |
+ +-+-+ + +-+-+ +-+ +-+ + +-+ + +-+-+-+-+ +-+ + +-+ +-+ + +-+-+ + +-+ + +-+-+-+-+-+-+ + +-+ +-+ +-+-+
|   |   | |     | |   | |     | |         |   | |   | | | |   | |   | |   | |     |   |   |   | |   |
+-+-+ +-+ + +-+-+ +-+ + +-+ +-+ +-+-+ +-+-+ +-+-+ +-+ + + + +-+ +-+ +-+-+ + + + +-+ +-+ +-+-+ + + + +
|     |   |   |     | |   |     |   |   |   |     |       |   |   |       |   | |   | |       |   | |
+ +-+-+ +-+-+ +-+-+ + +-+ +-+-+ + + +-+ + +-+ +-+ +-+-+-+-+ + +-+ +-+-+-+-+-+-+ + +-+ +-+-+-+-+-+-+ +
|   |       |     | |   |   |   | | |     |   |   |   |     |   | |   |       | |   |     |         |
+ + +-+ + +-+-+-+ + +-+ +-+ + +-+ + +-+-+-+ +-+ +-+ + +-+-+ +-+ + + + + +-+-+ + +-+ + +-+ + +-+-+-+ +
| |   | |       | | |     | |   | |     |   | | |   |     |   | |   | |   |     |   |   |   | |     |
+ +-+ + +-+-+-+ + + + +-+-+ +-+-+ +-+-+ + +-+ + + +-+-+-+ +-+ + +-+-+ +-+ +-+-+-+ +-+ + +-+-+ + +-+-+
| | | |   |     |   |     | |   | |       |     |       | |   |     |     |       |   | |     |   | |
+ + + +-+-+ +-+-+-+ +-+-+ + + + + + +-+-+-+ +-+-+-+ +-+-+ +-+-+ + + +-+-+ + +-+-+-+-+-+ + +-+ +-+ + +
|   |     |       | |   | | | |   | |   | |   |     |   | |   | | |     | | |   |       |   |   | | |
+-+ +-+-+ +-+ +-+ + + + + + + +-+ +-+ + + +-+ + +-+-+ + + + + + + +-+-+-+ + + +-+ + +-+-+ +-+-+ + + +
| | |   |   |   |     | |     |   |   | |     |     | |   | | | |   |     | |     |   |   |   | |   |
+ + +-+ +-+ + +-+-+-+-+ +-+-+-+-+-+ +-+ +-+ +-+-+ +-+ + +-+ + +-+ + + +-+-+ + +-+-+-+ +-+-+ + + +-+ +
| |       | | |   |     |         |   |   | |     |   | |   |   | |       | |       | |     | | |   |
+ +-+ +-+-+ + + + + +-+-+ +-+-+-+ +-+ +-+ +-+ +-+-+ +-+-+ +-+-+ +-+-+-+-+ + +-+-+-+ + + +-+-+ + + +-+
|   | |     | | | |   |   |   | |   |   |       |   |     |     |   |   | | |       |   |     | | | |
+ + + + +-+-+-+ + + +-+ +-+ + + + +-+-+ +-+-+-+-+ +-+ +-+-+ +-+-+ + + + +-+ +-+-+ +-+-+-+ +-+-+ + + +
| |   | |       | | |   |   | | |       | |     |   | |   |       |   |   | |   | |       | |   |   |
+-+-+-+ + +-+-+-+ +-+ +-+ +-+ + +-+-+-+-+ + +-+ +-+ + +-+ +-+-+-+-+-+-+-+ + + + +-+ +-+-+-+ + + +-+ +
|       |       |   | |   | | |   |       | | |   | | |                 | |   |   |   |   |   |   | |
+ +-+-+-+-+ +-+-+-+ + +-+ + + + + +-+-+-+ + + +-+ + + + +-+-+-+-+ +-+-+-+ +-+-+-+ +-+ + +-+ +-+-+ + +
|           |       |     |     |         | |   | |     |     |   |     |       |   | | |   |   | | |
+-+-+-+-+-+-+ +-+-+ +-+-+-+ +-+-+-+-+-+-+ + + +-+ +-+-+ + +-+ +-+-+ +-+ +-+ +-+ +-+ + + + +-+ + + + +
|     |     |   |   | |   | |   |     |   | |   |     | | |     |   |       | |   |   |   |   | |   |
+ +-+ + +-+ +-+ + +-+ + + + + + + +-+ +-+-+ + + +-+-+ +-+ +-+-+ + +-+-+-+-+-+ +-+ +-+-+ +-+ +-+ +-+-+
| |   | | | |   |     | |   | | |   |     | | |     |   |   |     |         |   |   | |     | |   | |
+ + +-+ + + + +-+-+-+ + +-+-+ + +-+ +-+-+ + +-+ +-+-+-+ +-+ +-+-+ + +-+-+-+ + + +-+ + +-+-+-+ +-+ + +
| |     |     |       | |     |     |   | | |   |     |   |   |   | |   |   | |   | |           |   |
+ +-+-+-+-+-+-+-+-+-+-+ + +-+-+-+-+-+ + + + + + + +-+ +-+ + + +-+ + + +-+ +-+ +-+-+ + +-+-+-+-+ +-+ +
|   |                   | | |         | | | | | |   |     | |   | |   |   |     |   | |       |   | |
+ + + +-+-+-+-+-+-+-+-+-+ + + +-+-+-+ + + + + +-+-+ +-+-+-+ +-+ +-+ +-+ +-+-+-+ + +-+ +-+ +-+ + +-+ +
| | |       |   |     |   | | |     | | |   | |   | |     |   |   | |   |       |   |   |   | | |   |
+ + +-+-+-+ + + +-+ + + +-+ + + +-+ +-+ +-+-+ + + + + +-+ +-+ +-+ + + +-+ + +-+-+-+ +-+ +-+ + + + +-+
| |       |   |   | | | |     |   |   |         |   |   | | |   |   |   | | |     |     | | |   |   |
+ +-+ +-+ +-+-+-+ + + + +-+-+ +-+ +-+ +-+-+-+ +-+-+-+-+ + + +-+ +-+-+ + + +-+ + +-+-+-+-+ + +-+-+-+ +
| | |   |     | |   | | |   | |   | |       | |         | |     |   | | |   | |       |     | |   | |
+ + +-+ +-+-+ + +-+-+ + + + +-+ +-+ +-+-+-+ + +-+-+-+ +-+ +-+ +-+ + +-+ + + + +-+ +-+ + +-+-+ + + + +
| |   | |   | |     | |   |     |       |   | |       | |   |   | |     | | |   |   | | |     | |   |
+ + +-+ + + + +-+ + + +-+-+-+-+-+ +-+ + + +-+ + +-+-+-+ +-+ +-+-+ +-+-+-+-+ +-+ +-+ + + +-+ + + +-+-+
| |   |   | |     | | |   |     |   | | | |     |         |     | |         |   | | | |   | | |   | |
+ +-+ +-+-+ +-+-+-+-+ + + + + + +-+-+ + + +-+-+-+ +-+-+-+ +-+-+ + + + +-+-+-+ +-+ + +-+-+ + + +-+ + +
|         |           | |   | |       | |     |     |   |     |   | | |     | |   |     |   | |   | |
+-+-+-+-+ +-+-+-+-+-+-+-+ +-+ +-+-+-+-+ +-+-+ +-+-+-+ + +-+ + +-+-+-+ + +-+ + +-+ +-+-+ +-+-+ + +-+ +
|     |   |     |   |   | |   | |     | |   | |     | |   | |         | |   |     | |     |   |   | |
+ +-+ + +-+ +-+ + + + + +-+ +-+ + + +-+ + +-+ + +-+ + +-+ +-+ +-+ +-+-+ + +-+-+-+ + + +-+-+ +-+-+ + +
|   | | |   | |   | | |     |     |   |   |   |   |   | |   |   | |     |         | |     |     |   |
+ +-+ + + +-+ +-+-+ + +-+-+-+ +-+-+-+ +-+ + +-+-+ +-+-+ +-+ + + +-+ +-+-+-+-+ +-+-+ +-+-+ +-+-+ +-+ +
| |   | |   | |   | |       |   |   |   | |   |   |       | | | |   |       | |     |   |       |   |
+ + +-+ +-+ + + + + + +-+-+ +-+ + + + +-+ +-+ + +-+-+ +-+ + +-+ + +-+ +-+-+ + + +-+ + + +-+-+-+-+ +-+
| |   |     |   |   |     | | |   | |   | | | |       |   |   |     | |   | |   |   | | |         | |
+ +-+ +-+-+-+ +-+-+-+-+-+-+ + +-+-+ +-+ + + + +-+-+-+-+ +-+-+ +-+-+ + + + + +-+-+ +-+ + + +-+-+-+-+ +
| | |   |   | |             |     | | |   | |       |   |   | |   | | | | | |   | |   | |   | |     |
+ + + + +-+ + +-+ +-+-+-+-+-+ +-+-+ + +-+-+ +-+-+ + + +-+ + + + + +-+ +-+ + + + +-+ +-+ +-+ + + +-+ +
|   | | |   |   | |       |         |           | | | |   | |   | |       | | |     |   | | |   |   |
+-+-+ + + +-+-+ + + +-+-+-+ +-+-+-+-+ + +-+-+-+-+ +-+ + + + +-+-+ + +-+-+-+ + +-+-+-+ + + + +-+-+ + +
|     |   |     | |       |   |       |         | |   | | | |     |   |     |   |   | | | |       | |
+ +-+-+-+ + +-+-+ +-+-+-+ +-+ +-+-+-+-+-+ +-+-+ + + +-+-+ + + +-+ +-+ + +-+ + +-+ + + + + +-+-+-+-+ +
|   |   | |       |         |     |     |     | |   |     | |   | |   | |   | |   | | | |   |     | |
+ + + + + +-+-+-+-+ +-+-+-+-+-+-+ + +-+ +-+-+-+ +-+-+ +-+ +-+-+ +-+ +-+ +-+-+ + +-+ + + + + + + +-+ +
| |   | |         |           |   | |   |       |   | |   |     |   | |       |   |   |   | | | |   |
+ +-+-+ +-+-+-+-+-+ +-+-+-+ +-+ +-+ + +-+ +-+-+ + + + + +-+ +-+-+ +-+ +-+-+-+-+-+ +-+-+-+-+-+ + + +-+
|     |                   |         |     |       |   |   |                     |             |     |
+-+-+-+-+-+-+-+-+-+-+-+-+-+-+-+-+-+-+-+-+-+-+-+-+-+-+-+-+-+-+-+-+-+-+-+-+-+-+-+-+-+-+-+-+-+-+-+-+-+-+
